▲▲▲▲▲▲▲▲▲▲▲▲▲▲▲▲▲▲▲▲▲▲▲▲▲▲▲▲▲▲▲▲▲▲▲▲▲▲▲▲▲▲▲▲▲▲▲▲▲▲▲▲▲▲▲▲▲▲▲▲▲▲▲▲▲▲▲▲▲
▲▲▲▲▲▲▲▲▲▲▲▲▲▲▲▲~▲▲▲▲▲▲▲▲▲▲▲▲▲▲▲▲▲▲▲▲▲▲▲▲▲▲▲▲▲▲▲▲▲▲▲▲▲▲▲▲▲▲▲▲▲▲▲▲▲▲▲▲
▲▲▲▲▲▲▲▲▲▲▲▲▲▲X▲▲~~▲      ▲▲▲   ▲▲         ♣♣♣♣♣▲▲▲▲▲▲▲▲▲▲▲▲▲▲▲▲▲▲▲▲▲
▲▲▲▲▲▲▲▲▲▲▲▲     ~~~ ▲▲    ▲▲▲▲▲ ♣♣♣♣    ♣♣♣♣♣♣♣♣▲▲▲▲▲▲▲▲▲▲▲▲▲▲▲▲▲▲▲▲      
▲▲▲▲▲▲▲▲         ~~~~~ ♣♣♣♣♣▲▲▲▲▲▲♣♣♣♣♣     ♣♣♣♣♣♣♣▲▲▲▲▲▲▲▲▲▲▲▲ ?▲▲▲▲
▲▲▲▲▲             ~~~~~~~ ♣♣♣♣♣♣♣♣♣♣♣♣♣          ♣♣♣♣♣♣▲▲▲▲▲▲▲   ▲▲▲▲
▲▲▲▲               ~~~~~~    ♣♣♣♣♣♣              ♣♣♣♣    ♣♣▲▲▲  ▲▲▲▲▲
▲▲▲▲▲▲♣♣♣             ~~~~~~~~   ♣♣♣♣♣            ♣♣♣♣  ♣♣      ▲▲▲▲▲
▲▲▲▲                   ~~~~~~     ▲▲▲ ▲▲▲             ♣♣♣♣♣▲▲▲▲▲▲▲▲▲▲
▲▲▲                    ~~~~~     ▲▲▲▲  ▲▲▲        ♣♣♣   ♣♣▲▲▲▲▲▲▲▲▲▲▲
▲▲▲                     ~~~~~      ▲▲  ▲▲           ♣♣♣    ▲▲▲▲▲▲▲▲▲▲
▲▲▲                   ~~~~~~~~      ▲▲▲▲              ♣♣♣  ♣♣▲▲▲▲▲▲▲▲
▲▲▲▲              ╔══╗╔══╗╔══╗       ▲▲                ♣♣♣   ♣▲▲▲▲▲▲▲
▲▲▲▲▲                ~~~~~~~                          ♣        ▲▲▲▲▲▲
▲▲▲▲▲▲              ~~~~~~~~~                                   ▲▲▲▲▲
▲▲▲▲▲♣♣♣♣♣           ~~~~~~~                                     ▲▲▲▲
▲▲▲▲     ♣♣           ~~~~~~                                       ▲▲
▲▲▲♣♣♣♣   ♣♣          ~~~~~~~                                   ░░███
█▲▲  ♣♣♣♣             ~~~~~~~                                 ░░░████
█▲▲♣♣♣        ♣        ~~~~~~~                              ░░░░█████
██ ♣♣   ♣♣  ♣♣           ~~~~                             ░░░░░██████
███   ♣♣♣  ♣♣♣           ~~~~~~~                           ░░░░██████   
████  ♣♣  ♣♣♣           ~~~~~~~~     ♣♣    ♣♣             ░░░░░░█████
███ ♣ ♣♣ ♣♣♣♣           ~~~~~~~   ♣♣♣♣♣♣  ♣♣♣♣  ♣       ░░░░░░███████
██ ♣  ♣♣? ♣♣♣♣           ~~~~~   ♣♣♣♣♣♣♣♣♣♣♣♣   ♣♣       ░░E░░░░█████
██ ♣ ♣♣♣♣♣♣♣♣            ~~~~~~  ♣♣ ♣♣♣ ♣♣♣♣  ♣♣♣♣        ░░░░███████  
██ ♣     ♣♣♣♣           ~~~~~~~   ♣♣♣♣♣♣♣♣♣  ♣♣♣           ░░░░██████
███ ♣♣♣ ♣♣      ██████  ~~~~~~~~~~~   ♣♣♣♣? ♣♣  ███        ░░░███████
████ ♣♣ ♣♣   ███████████████████████    ♣♣♣   █████████  ██░░████████
█████████████████████████████████████████████████████████████████████  
█████████████████████████████████████████████████████████████████████  
